000000000000@
@000000000000
0030000030000
00#00#00#0000
0000030000000
00#00#00#0000
00@0000000000
